repeat_unit	structure
A	HAIRP
AAAAAT	UNF
AAAAG	UNF
AAAAGC	UNF
AAAAGT	UNF
AAAAT	UNF
AAAATG	UNF
AAAATT	UNF
AAAC	UNF
AAACAG	UNF
AAACAT	UNF
AAACCT	UNF
AAACGT	UNF
AAACT	UNF
AAACTT	UNF
AAAG	UNF
AAAGAC	UNF
AAAGAG	UNF
AAAGCG	UNF
AAAGCT	UNF
AAAGGT	UNF
AAAGTT	UNF
AAAT	UNF
AAATAC	UNF
AAATAG	UNF
AAATAT	UNF
AAATC	UNF
AAATCG	UNF
AAATCT	UNF
AAATG	UNF
AAATGC	UNF
AAATGG	UNF
AAATGT	UNF
AAATT	UNF
AAATTC	UNF
AAATTG	UNF
AAC	UNF
AACAG	UNF
AACAGC	UNF
AACAGG	UNF
AACAGT	UNF
AACATC	UNF
AACATG	UNF
AACATT	UNF
AACCTT	UNF
AACGCG	UNF
AACGCT	UNF
AACGGT	UNF
AACGT	UNF
AACGTC	UNF
AACGTT	HAIRP
AACT	UNF
AACTAC	UNF
AACTAG	UNF
AACTG	UNF
AACTGT	UNF
AAG	UNF
AAGAAT	UNF
AAGAC	UNF
AAGACG	UNF
AAGACT	UNF
AAGAGC	UNF
AAGAGT	UNF
AAGAT	UNF
AAGATC	UNF
AAGATG	UNF
AAGATT	UNF
AAGCAT	UNF
AAGCC	UNF
AAGCCG	UNF
AAGCGC	UNF
AAGCGG	UNF
AAGCGT	UNF
AAGCTT	HAIRP
AAGGAT	UNF
AAGGCT	UNF
AAGGT	UNF
AAGGTC	UNF
AAGTAC	UNF
AAGTAG	UNF
AAGTAT	UNF
AAT	UNF
AATACG	UNF
AATACT	UNF
AATAG	UNF
AATAGC	UNF
AATAGG	UNF
AATAGT	UNF
AATAT	UNF
AATATC	UNF
AATATG	UNF
AATATT	UNF
AATC	UNF
AATCAG	UNF
AATCAT	UNF
AATCCG	UNF
AATCCT	UNF
AATCG	UNF
AATCGG	UNF
AATCGT	UNF
AATCT	UNF
AATGAC	UNF
AATGAG	UNF
AATGC	UNF
AATGCC	UNF
AATGCG	UNF
AATGCT	UNF
AATGG	UNF
AATGGG	UNF
AATGTC	UNF
AATGTG	UNF
AATT	UNF
AATTAC	UNF
AATTAG	UNF
AATTAT	UNF
AATTC	UNF
AATTCC	UNF
AATTGC	HAIRP
ACACAT	UNF
ACAGAT	UNF
ACAGCG	UNF
ACAGCT	UNF
ACAGT	UNF
ACAGTC	UNF
ACATAG	UNF
ACATAT	UNF
ACATCT	UNF
ACATG	UNF
ACATGC	UNF
ACATGG	UNF
ACCATG	UNF
ACCGCT	UNF
ACCGT	UNF
ACCTAG	UNF
ACCTAT	UNF
ACGATC	UNF
ACGCAT	UNF
ACGCCT	UNF
ACGCG	HAIRP
ACGCGT	HAIRP
ACGCTG	UNF
ACGGAT	UNF
ACGTAG	UNF
ACGTCG	HAIRP
ACGTGC	HAIRP
ACT	UNF
ACTAGC	UNF
ACTAGG	UNF
ACTAT	UNF
ACTATG	UNF
ACTCAT	UNF
ACTCGG	UNF
ACTCTG	UNF
ACTGAG	UNF
ACTGG	UNF
AGAGAT	UNF
AGAGCC	UNF
AGAGCT	UNF
AGAT	UNF
AGATAT	UNF
AGATCC	UNF
AGCAT	UNF
AGCATC	UNF
AGCCAT	UNF
AGCCT	UNF
AGCGCG	HAIRP
AGCTC	UNF
AGCTCG	HAIRP
AGGATC	UNF
AGGCAT	UNF
ATATC	UNF
ATATCC	UNF
ATC	UNF
ATCCG	UNF
ATCCGC	UNF
ATCCGG	HAIRP
ATCGC	UNF
ATCGCG	HAIRP
ATGCC	UNF
ATGGCC	HAIRP
CCCGGG	HAIRP
CCGCGG	HAIRP
CCGG	HAIRP
CCGGCG	HAIRP
CG	HAIRP
AAAAAG	UNF
AAAACG	UNF
AAACCG	UNF
AACACG	UNF
AACCG	UNF
AACCAG	UNF
ACAG	UNF
ACACAG	UNF
ACACCG	UNF
AAGACC	UNF
AAGAG	UNF
AGC	UNF
AAAGC	UNF
ACAGC	UNF
AAGCAC	UNF
ACCAGC	UNF
AGAGC	UNF
AAGCAG	UNF
ACAGCC	UNF
AAGCG	UNF
AGAGCG	UNF
ACGCGC	HAIRP
AAAAGG	UNF
AACGG	UNF
AACCGG	UNF
AAGGAC	UNF
ACCAGG	UNF
ACGAGG	UNF
AGCAGG	UNF
AAGGC	UNF
AACGGC	UNF
ACAGGC	UNF
AAGGCC	UNF
CCCG	QUAD
CCGCG	UNF
CCCCG	QUAD
CCCCCG	QUAD
ACGCCC	QUAD
AGCCGG	HAIRP
AGCCC	QUAD
AGCCCC	QUAD
AAGCCC	QUAD
AACGGG	UNF
AGCGGG	UNF
AAGGGC	UNF
CCCCGG	QUAD
ACCCCC	QUAD
AACCCC	QUAD
ACCCCG	QUAD
ACCCC	QUAD
ACC	QUAD
ACCCG	QUAD
ACCC	QUAD
ACACCC	QUAD
AACACC	UNF
AACC	UNF
AACCC	QUAD
AACCGC	UNF
AACCAC	UNF
AAACC	QUAD
AAAACC	UNF
AC	UNF
ACCGGG	IMOT
ACCGAG	UNF
ACACC	UNF
ACACGG	UNF
AACAC	UNF
AACGC	UNF
AAACGC	UNF
AAAAC	UNF
AAAAAC	UNF
AAAGT	UNF
AAAGAT	UNF
AACAT	UNF
AACAAT	UNF
AACACT	UNF
AACCAT	UNF
AACCGT	UNF
AAGT	UNF
AATAC	UNF
ACACCT	UNF
ACACGT	UNF
ACAGGT	UNF
ACCAT	UNF
ACCACT	UNF
ACCAGT	UNF
ACCGAT	UNF
ACGAT	UNF
ACGAGT	UNF
ACCCGT	UNF
ACTCT	UNF
ACTGCT	UNF
ACGGCT	UNF
ACGCT	UNF
AGCGAT	UNF
ACCT	UNF
AGGGAT	UNF
ACGACT	HAIRP
AACTAT	UNF
AATACC	UNF
AAACTC	UNF
AAAGTC	UNF
AACTC	UNF
AACCTC	UNF
AAGTC	UNF
AATCAC	UNF
ACACTC	UNF
ACCATC	UNF
ACGTC	UNF
ACTATC	UNF
ACTG	UNF
ACTCAG	UNF
AGCCTG	UNF
ACTGAT	UNF
AGG	UNF
ATCC	UNF
AATCC	UNF
AAATCC	UNF
AACTCC	UNF
ACTCC	UNF
ACATCC	UNF
AGCTCC	UNF
ACCTGG	UNF
ACGGGG	UNF
ACGGG	UNF
ACAGGG	UNF
ACGG	UNF
AGGCGG	UNF
ACGGAG	UNF
AGGAT	UNF
ACTCCT	UNF
AGGATG	UNF
ACATCG	UNF
ACTCG	UNF
AGGCG	UNF
AGGGCG	UNF
ACGGCG	IMOT
ACTCCG	UNF
AGCCG	UNF
ATCCCG	UNF
ACGAG	UNF
ACGATG	UNF
AACTCT	UNF
ACCTCT	UNF
ACTAG	UNF
AATCTC	UNF
AGAGG	UNF
AGATGG	UNF
AGAGGG	UNF
AGATCG	UNF
AATG	UNF
AAAGTG	UNF
AACGTG	UNF
AAGTG	UNF
AAGCTG	UNF
AATCTG	UNF
ACACTG	UNF
ACCGTG	UNF
ACTC	UNF
AGCATG	UNF
ACGCTC	UNF
ACCCTC	UNF
AATGAT	UNF
ACATC	UNF
AACTGC	UNF
ACCTGC	UNF
ACTGC	UNF
AGATGC	UNF
AGGC	UNF
AGGGC	UNF
ACGGGC	UNF
ACGGC	UNF
ATCGGC	UNF
AGCGGC	UNF
ACTCGC	UNF
ACGCAG	UNF
ACGTCC	UNF
AGCC	UNF
AATGGC	UNF
ACTGGC	UNF
ACTGCC	UNF
ATCCC	QUAD
ACTCCC	UNF
ATGCCC	UNF
ATCCCC	QUAD
ACCCAG	UNF
ACAT	UNF
AAGTGT	UNF
AATGGT	UNF
AAGGGT	UNF
AAGTCT	UNF
AAGCT	UNF
AAGCCT	UNF
AACCCT	UNF
AACGAT	UNF
AAGGTG	UNF
AAGGG	UNF
AAGGGG	UNF
AAGAGG	UNF
AACTCG	UNF
AAGGCG	UNF
AACGAG	UNF
AACTTG	UNF
AAGC	UNF
AAGTGC	UNF
AATCCC	UNF
AACAAG	UNF
AAACTG	UNF
AAACG	UNF
AAACAC	UNF
AAAACT	UNF
AAAATC	UNF
